0000000000
0        0
0    X   0
000.000000
0        0
00U0000000